id,QUEUE_ID,count,ranges_start,ranges_end,test_start,test_end
0,2,19255,0,19254,0,3820
1,3,19257,19255,38511,3821,7642
2,4,19257,38512,57768,7643,11464
3,27,10526,57769,68294,11465,13539
4,36,3242,68295,71536,13540,14158
5,233,2099,71537,73635,14159,14548
6,287,6876,73636,80511,14549,15893
7,291,8884,80512,89395,15894,17640
8,293,8855,89396,98250,17641,19381
9,21825,19723,98251,117973,19382,23296
10,82695,19726,117974,137699,23297,27211
11,82697,10642,137700,148341,27212,29310
12,82929,10199,148342,158540,29311,31320
13,83109,8958,158541,167498,31321,33082
14,84387,17520,167499,185018,33083,36556
15,84907,6495,185019,191513,36557,37825
16,85101,6618,191514,198131,37826,39119
17,85153,14353,198132,212484,39120,41960
18,85265,13516,212485,226000,41961,44633
19,85267,13082,226001,239082,44634,47220
20,85619,9997,239083,249079,47221,49190
21,85693,10834,249080,259913,49191,51327
22,85731,8568,259914,268481,51328,53011
23,85781,1149,268482,269630,53012,53211
24,85915,9220,269631,278850,53212,55025
25,85933,8811,278851,287661,55026,56757
26,85977,8793,287662,296454,56758,58486
27,86085,6195,296455,302649,58487,59695
28,86865,3544,302650,306193,59696,60374
29,86867,3753,306194,309946,60375,61095
30,87139,2378,309947,312324,61096,61541
