id,QUEUE_ID,count,ranges_start,ranges_end,test_start,test_end
0,2,19255,0,19254,0,3812
1,3,19257,19255,38511,3813,7625
2,4,19257,38512,57768,7626,11438
3,27,10526,57769,68294,11439,13505
4,36,3242,68295,71536,13506,14115
5,233,2099,71537,73635,14116,14497
6,287,6876,73636,80511,14498,15834
7,291,8884,80512,89395,15835,17573
8,293,8855,89396,98250,17574,19306
9,21825,19723,98251,117973,19307,23212
10,82695,19726,117974,137699,23213,27119
11,82697,10642,137700,148341,27120,29209
12,82929,10199,148342,158540,29210,31211
13,83109,8958,158541,167498,31212,32964
14,84387,17520,167499,185018,32965,36430
15,84907,6495,185019,191513,36431,37691
16,85101,6618,191514,198131,37692,38976
17,85153,14353,198132,212484,38977,41808
18,85265,13516,212485,226000,41809,44473
19,85267,13082,226001,239082,44474,47051
20,85619,9997,239083,249079,47052,49012
21,85693,10834,249080,259913,49013,51141
22,85731,8568,259914,268481,51142,52816
23,85781,1149,268482,269630,52817,53008
24,85915,9220,269631,278850,53009,54814
25,85933,8811,278851,287661,54815,56538
26,85977,8793,287662,296454,56539,58258
27,86085,6195,296455,302649,58259,59459
28,86865,3544,302650,306193,59460,60130
29,86867,3753,306194,309946,60131,60842
30,87139,2378,309947,312324,60843,61279
